1,1,1,1,1,1,1,1
1,c,0,0,0,0,2,1
1,1,a,1,1,a,1,1
1,0,0,0,0,0,0,1
1,1,a,1,1,a,1,1
1,p,0,0,0,0,0,1
1,1,1,1,1,1,1,1