1,1,1,1,1,1,1,1,1
1,0,0,a,0,0,a,0,1
1,0,0,0,1,0,r,0,1
1,r,a,1,1,1,0,0,1
1,0,0,0,1,2,a,0,1
1,0,p,0,0,0,0,0,1
1,1,1,1,1,1,1,1,1