1,1,1,1,1,1,1,1,1,1,1,1,1
1,0,0,1,0,1,1,1,0,b,0,0,1
1,0,2,0,0,0,0,1,0,p,0,b,1
1,0,0,0,0,0,0,0,0,b,0,0,1
1,1,1,1,1,0,0,1,1,1,1,1,1
1,0,0,0,1,0,0,1,0,2,1,1,1
1,0,b,0,0,0,0,0,0,0,1,1,1
1,0,0,0,1,0,0,1,0,0,1,1,1
1,1,1,1,1,1,1,1,1,1,1,1,1