1,1,1,1,1,1,1,1,1,1,1,1,1,1,1,1,1,1,1,1,1
1,0,0,0,0,0,0,0,0,0,0,0,0,0,0,0,0,0,0,0,1
1,0,0,p,0,0,a,0,0,a,0,0,0,0,a,0,0,0,a,0,1
1,1,1,1,1,1,1,1,0,0,0,0,1,1,1,1,1,a,a,a,1
1,0,0,0,1,0,0,0,0,a,0,0,1,0,0,0,1,0,a,0,1
1,0,0,0,1,0,a,0,0,1,1,1,1,0,a,a,1,1,1,1,1
1,0,2,0,0,0,0,0,0,0,0,0,0,0,a,a,1,b,b,b,1
1,0,0,0,a,0,a,0,0,0,0,0,0,0,a,a,0,0,0,0,1
1,1,1,1,1,1,1,1,1,1,1,1,1,1,1,1,1,1,1,1,1