1,1,1,1,1,1,1,1,1,1,1,1
1,0,0,a,0,0,0,1,0,0,0,1
1,0,0,0,0,p,0,1,0,a,0,1
1,0,0,1,1,0,0,1,1,0,0,1
1,0,a,a,1,0,0,0,0,a,0,1
1,0,a,a,1,0,0,0,2,0,0,1
1,1,1,1,1,1,1,1,1,1,1,1
