1,1,1,1,1,1,1,1
1,2,0,0,0,0,0,1
1,0,a,0,c,0,r,1
1,0,0,b,0,0,0,1
1,p,0,0,0,0,m,1
1,1,1,1,1,1,1,1