1,1,1,1,1,1,1,1
1,0,1,0,m,0,p,1
1,2,b,0,0,m,0,1
1,1,1,0,0,0,0,1
1,0,m,0,1,0,0,1
1,1,1,1,1,1,1,1