1,1,1,1,1,1,1,1,1
1,0,m,0,1,1,1,2,1
1,0,0,0,0,0,0,m,1
1,0,0,p,0,0,0,0,1
1,1,0,0,1,0,0,1,1
1,m,0,0,1,0,0,m,1
1,1,1,1,1,1,1,1,1