1,1,1,1,1,1,1
1,m,2,1,0,m,1
1,0,0,0,0,0,1
1,1,0,p,0,1,1
1,m,0,0,0,m,1
1,1,1,1,1,1,1