1,1,1,1,1,1,1,1
1,0,0,r,0,0,0,1
1,a,a,2,0,0,0,1
1,a,0,0,0,a,p,1
1,a,a,a,a,a,0,1
1,1,1,1,1,1,1,1