1,1,1,1,1,1,1,1,1,1,1,1
1,1,1,0,0,0,0,r,0,1,1,1
1,1,2,0,b,0,0,0,0,0,1,1
1,1,0,0,0,0,0,b,0,2,1,1
1,r,0,0,0,0,0,0,0,1,1,1
1,0,0,0,p,0,0,0,0,1,1,1
1,1,1,1,1,1,1,1,1,1,1,1
