1,1,1,1,1,1,1,1,1,1,1
1,a,r,a,a,a,a,a,a,a,1
1,a,1,1,a,a,2,1,c,a,1
1,p,a,1,a,1,1,1,1,a,1
1,a,a,1,a,1,1,1,a,a,1
1,1,1,1,1,1,1,1,1,1,1